004	L-PEPTIDE LINKING
005	PEPTIDE-LIKE
006	PEPTIDE-LIKE
00B	L-PEPTIDE LINKING
00C	D-PEPTIDE LINKING
01W	L-PEPTIDE LINKING
0A0	L-PEPTIDE LINKING	ASP
0A1	L-PEPTIDE LINKING	TYR
0A2	L-PEPTIDE LINKING	LYS
0A8	L-PEPTIDE LINKING	CYS
0A9	L-PEPTIDE LINKING	PHE
0AA	L-PEPTIDE LINKING	VAL
0AB	L-PEPTIDE LINKING	VAL
0AC	L-PEPTIDE LINKING	GLY
0AD	DNA LINKING	DG
0AF	L-PEPTIDE LINKING	TRP
0AG	PEPTIDE-LIKE	LEU
0AH	L-PEPTIDE LINKING	SER
0AK	L-PEPTIDE LINKING	ASP
0AM	DNA LINKING	DA
0AP	DNA LINKING	DC
0AT	D-SACCHARIDE
0AU	DNA LINKING	DU
0AV	DNA LINKING	DA
0AY	PEPTIDE-LIKE
0AZ	L-PEPTIDE LINKING	PRO
0BD	D-SACCHARIDE
0BN	L-PEPTIDE LINKING	PHE
0C	L-RNA LINKING
0CS	L-PEPTIDE LINKING	ALA
0D5	PEPTIDE-LIKE
0DC	L-DNA LINKING
0DG	L-DNA LINKING
0DT	L-DNA LINKING
0E2	PEPTIDE-LIKE
0E3	PEPTIDE-LIKE
0E4	PEPTIDE-LIKE
0EZ	PEPTIDE-LIKE
0FA	PEPTIDE-LIKE
0G	L-RNA LINKING
0G6	PEPTIDE-LIKE
0HG	PEPTIDE-LIKE
0NC	L-PEPTIDE NH3 AMINO TERMINUS	ALA
0PJ	PEPTIDE-LIKE
0PN	PEPTIDE-LIKE
0PQ	PEPTIDE-LIKE
0SP	DNA LINKING	DA
0U	L-RNA LINKING
0YG	L-PEPTIDE NH3 AMINO TERMINUS	TYR	GLY
0Z6	PEPTIDE-LIKE
10C	RNA LINKING	C
10M	D-SACCHARIDE
125	RNA LINKING	U
126	RNA LINKING	U
127	RNA LINKING	U
128	RNA LINKING
12A	RNA LINKING	A
143	L-PEPTIDE LINKING	CYS
147	D-SACCHARIDE
149	D-SACCHARIDE
14T	SACCHARIDE
16G	D-SACCHARIDE
175	L-PEPTIDE LINKING	ALA	SER	GLY
193	L-PEPTIDE LINKING
1AP	DNA LINKING	DA
1AR	L-SACCHARIDE
1DP	RNA LINKING
1GL	D-SACCHARIDE
1GN	SACCHARIDE
1MA	RNA LINKING	A
1MG	RNA LINKING	G
1NA	SACCHARIDE
1PA	L-PEPTIDE LINKING	PHE
1PI	L-PEPTIDE LINKING	ALA
1PR	RNA LINKING
1SC	RNA LINKING	C
1TQ	L-PEPTIDE LINKING	TRP
1TY	L-PEPTIDE LINKING	TYR
1ZD	PEPTIDE-LIKE
1ZN	PEPTIDE-LIKE
1ZT	PEPTIDE-LIKE
200	L-PEPTIDE LINKING	PHE
23F	PEPTIDE LINKING	PHE
23G	RNA OH 3 PRIME TERMINUS	G
23S	L-PEPTIDE LINKING
26B	L-PEPTIDE COOH CARBOXY TERMINUS	THR
289	D-SACCHARIDE
291	D-SACCHARIDE
293	D-SACCHARIDE
2AD	L-PEPTIDE LINKING
2AG	L-PEPTIDE LINKING	ALA
2AO	L-PEPTIDE LINKING
2AR	DNA LINKING	DA
2AS	L-PEPTIDE LINKING
2AT	DNA LINKING	DT
2AU	RNA LINKING	U
2BD	DNA LINKING	DI
2BT	DNA LINKING	DT
2BU	DNA LINKING	DA
2CO	L-PEPTIDE LINKING	CYS
2DA	DNA LINKING	DA
2DF	DNA LINKING
2DG	SACCHARIDE
2DM	DNA LINKING
2DO	L-PEPTIDE LINKING
2DT	DNA LINKING	DT
2EG	DNA LINKING	G
2FE	DNA LINKING
2FG	SACCHARIDE
2FI	DNA LINKING
2FL	SACCHARIDE
2FM	L-PEPTIDE LINKING	MET
2FP	SACCHARIDE
2GL	D-SACCHARIDE
2GT	DNA LINKING	DT
2HF	L-PEPTIDE LINKING	HIS
2LU	L-PEPTIDE LINKING	LEU
2MA	RNA LINKING	A
2MG	RNA LINKING	G
2ML	L-PEPTIDE LINKING	LEU
2MR	L-PEPTIDE LINKING	ARG
2MT	L-PEPTIDE LINKING	PRO
2MU	RNA LINKING	U
2NC	PEPTIDE-LIKE
2NT	DNA LINKING	DT
2OM	RNA LINKING	U
2OT	DNA LINKING	DT
2PI	L-PEPTIDE LINKING
2PR	DNA LINKING	DG
2SA	RNA LINKING
2SI	L-PEPTIDE LINKING
2ST	DNA LINKING	DT
2TL	D-PEPTIDE LINKING
2TY	L-PEPTIDE LINKING	TYR
2VA	L-PEPTIDE LINKING	VAL
2Z9	PEPTIDE-LIKE
32S	L-PEPTIDE LINKING
32T	L-PEPTIDE LINKING
3A1	PEPTIDE-LIKE
3A2	PEPTIDE-LIKE
3AH	L-PEPTIDE LINKING	HIS
3AR	L-PEPTIDE LINKING
3CF	L-PEPTIDE LINKING	PHE
3CM	D-SACCHARIDE
3DA	DNA LINKING	DA
3DR	DNA LINKING
3FG	L-PEPTIDE LINKING
3FM	D-SACCHARIDE
3GA	L-PEPTIDE LINKING	ALA
3GL	L-PEPTIDE LINKING	GLU
3LR	L-SACCHARIDE
3MD	L-PEPTIDE LINKING	ASP
3ME	DNA LINKING	DU
3MF	SACCHARIDE
3MG	D-SACCHARIDE
3MM	D-PEPTIDE NH3 AMINO TERMINUS
3MY	D-PEPTIDE LINKING	TYR
3NF	L-PEPTIDE LINKING	TYR
3SA	SACCHARIDE
3TL	PEPTIDE-LIKE
3TY	L-PEPTIDE LINKING
3XH	L-PEPTIDE LINKING	GLY
40A	PEPTIDE-LIKE
40C	PEPTIDE-LIKE
40G	PEPTIDE-LIKE
40T	PEPTIDE-LIKE
46D	D-SACCHARIDE
46M	D-SACCHARIDE
47C	DNA LINKING	DC
4AC	RNA LINKING
4AF	L-PEPTIDE LINKING	PHE
4BF	L-PEPTIDE LINKING	TYR
4CF	L-PEPTIDE LINKING	PHE
4CY	L-PEPTIDE LINKING	MET
4DB	L-PEPTIDE LINKING
4DP	L-PEPTIDE LINKING	TRP
4F3	L-PEPTIDE LINKING	GLY	TYR	GLY
4FB	L-PEPTIDE LINKING	PRO
4FW	L-PEPTIDE LINKING	TRP
4GC	D-SACCHARIDE 1,4 AND 1,4 LINKING
4HT	L-PEPTIDE LINKING	TRP
4IN	L-PEPTIDE LINKING	TRP
4MF	DNA LINKING
4MM	L-PEPTIDE NH3 AMINO TERMINUS
4OC	RNA LINKING	C
4PC	DNA LINKING	DC
4PD	DNA LINKING	DC
4PE	DNA LINKING	DC
4PH	L-PEPTIDE LINKING	PHE
4SC	DNA LINKING	DC
4SU	RNA LINKING	U
4TA	RNA LINKING
5AA	DNA LINKING	DA
5AT	DNA LINKING	DT
5BU	RNA LINKING	U
5CF	RNA LINKING
5CG	DNA LINKING	DG
5CM	DNA LINKING	DC
5CS	L-PEPTIDE LINKING	CYS
5FA	RNA LINKING	A
5FC	DNA LINKING	DC
5FU	RNA LINKING	U
5HP	L-PEPTIDE LINKING	GLU
5HT	DNA LINKING	DT
5HU	DNA LINKING	DU
5IC	RNA LINKING	C
5IT	DNA LINKING	DT
5IU	DNA LINKING	DU
5MC	RNA LINKING	C
5MD	DNA LINKING
5MU	RNA LINKING	U
5NC	DNA LINKING	DC
5OH	L-PEPTIDE LINKING	ALA
5PC	DNA LINKING	DC
5PG	L-PEPTIDE LINKING	GLY
5PY	DNA LINKING	DT
5RP	SACCHARIDE
5SA	SACCHARIDE
5SE	DNA LINKING	DU
5SP	SACCHARIDE
5UA	DNA LINKING
5ZA	L-PEPTIDE LINKING	THR	TRP	GLY
63G	DNA LINKING	DG
63H	DNA LINKING	DG
64T	DNA LINKING	DT
6CL	L-PEPTIDE LINKING	LYS
6CT	DNA LINKING	DT
6CW	L-PEPTIDE LINKING	TRP
6HA	DNA LINKING	DA
6HC	DNA LINKING	DC
6HG	DNA LINKING	DG
6HN	L-PEPTIDE LINKING	LYS
6HT	DNA LINKING	DT
6IA	RNA LINKING	A
6MA	DNA LINKING	A
6MC	RNA LINKING	A
6MI	DNA LINKING
6MT	RNA LINKING	A
6MZ	RNA LINKING
6OG	DNA LINKING	DG
6PG	D-SACCHARIDE
6SA	SACCHARIDE
70U	RNA LINKING	U
7DA	DNA LINKING	DA
7GU	DNA LINKING	DG
7HA	L-PEPTIDE LINKING
7JA	L-PEPTIDE LINKING	ILE
7JZ	D-SACCHARIDE
7MG	RNA LINKING	G
8AG	DNA LINKING	DG
8AN	RNA LINKING	A
8FG	DNA LINKING	DG
8MG	DNA LINKING	DG
8OG	DNA LINKING	DG
9DN	L-PEPTIDE LINKING	ASN
9DS	L-PEPTIDE LINKING	GLY
9NE	L-PEPTIDE LINKING	GLU
9NF	L-PEPTIDE LINKING	PHE
9NR	L-PEPTIDE LINKING	ARG
9NV	L-PEPTIDE LINKING	VAL
A	RNA LINKING
A02	PEPTIDE-LIKE
A03	PEPTIDE-LIKE
A1P	DNA LINKING
A23	RNA LINKING	A
A2G	SACCHARIDE
A2L	RNA LINKING	A
A2M	RNA LINKING	A
A34	DNA LINKING	DA
A35	DNA LINKING	DA
A38	DNA LINKING	DA
A39	RNA LINKING	A
A3A	DNA LINKING	DA
A3P	RNA LINKING	A
A40	DNA LINKING	DA
A43	DNA LINKING	DA
A44	RNA LINKING	A
A47	DNA LINKING	DA
A5L	DNA LINKING	DA
A5M	RNA LINKING	C
A5O	RNA LINKING	A
A66	L-PEPTIDE LINKING
A67	PEPTIDE-LIKE
A70	PEPTIDE-LIKE
A9D	L-PEPTIDE LINKING	SER
AA3	L-PEPTIDE LINKING	ALA
AA4	L-PEPTIDE LINKING	ALA
AA6	'L-PEPTIDE LINKING'
AAB	SACCHARIDE
AAL	L-SACCHARIDE
AAO	SACCHARIDE
AAR	L-PEPTIDE LINKING	ARG
AB7	L-PEPTIDE LINKING
ABA	L-PEPTIDE LINKING	ALA
ABC	SACCHARIDE
ABD	SACCHARIDE
ABE	SACCHARIDE
ABF	D-SACCHARIDE
ABR	DNA LINKING	DA
ABS	DNA LINKING	DA
ABT	DNA LINKING
ACB	D-PEPTIDE LINKING
ACG	SACCHARIDE
ACI	D-SACCHARIDE
ACL	L-PEPTIDE LINKING	ARG
ACR	SACCHARIDE
ACX	SACCHARIDE
AD2	DNA LINKING	DA
ADA	D-SACCHARIDE
ADD	L-PEPTIDE LINKING
ADG	D-SACCHARIDE
ADR	D-SACCHARIDE
ADX	RNA LINKING
AEA	L-PEPTIDE LINKING
AEI	L-PEPTIDE LINKING	ASP
AET	RNA LINKING	A
AF1	SACCHARIDE
AF2	DNA LINKING	DA
AFA	L-PEPTIDE LINKING	ASN
AFF	DNA LINKING
AFG	DNA LINKING	DG
AFL	L-SACCHARIDE
AFP	SACCHARIDE
AGC	D-SACCHARIDE
AGD	D-PEPTIDE LINKING
AGH	D-SACCHARIDE
AGL	D-SACCHARIDE
AGM	L-PEPTIDE LINKING	ARG
AGQ	L-PEPTIDE LINKING	TYR
AGT	L-PEPTIDE LINKING
AHB	L-PEPTIDE LINKING	ASN
AHH	L-PEPTIDE LINKING
AHO	L-PEPTIDE LINKING	ALA
AHP	L-PEPTIDE LINKING	ALA
AHR	L-SACCHARIDE
AHS	PEPTIDE-LIKE
AHT	PEPTIDE-LIKE
AIB	L-PEPTIDE LINKING	ALA
AIG	SACCHARIDE
AKL	L-PEPTIDE LINKING	ASP
ALA	L-PEPTIDE LINKING
ALC	L-PEPTIDE LINKING	ALA
ALG	L-PEPTIDE LINKING	ARG
ALL	D-SACCHARIDE
ALM	L-PEPTIDE LINKING	ALA
ALN	L-PEPTIDE LINKING	ALA
ALO	L-PEPTIDE LINKING	THR
ALS	L-PEPTIDE LINKING	ALA
ALT	L-PEPTIDE LINKING	ALA
ALY	L-PEPTIDE LINKING	LYS
AMU	D-SACCHARIDE
AOG	SACCHARIDE
AOS	D-SACCHARIDE
AP7	RNA LINKING	A
APE	PEPTIDE-LIKE
APH	D-PEPTIDE LINKING
API	L-PEPTIDE LINKING	LYS
APK	L-PEPTIDE LINKING	LYS
APM	L-PEPTIDE LINKING
APN	PEPTIDE-LIKE
APO	D-PEPTIDE LINKING
APP	L-PEPTIDE LINKING
AR2	L-PEPTIDE LINKING	ARG
AR4	L-PEPTIDE LINKING	GLU
ARA	D-SACCHARIDE
ARB	D-SACCHARIDE
ARE	SACCHARIDE
ARF	L-PEPTIDE NH3 AMINO TERMINUS
ARG	L-PEPTIDE LINKING
ARI	D-SACCHARIDE
ARM	L-PEPTIDE LINKING	ARG
ARO	L-PEPTIDE LINKING	ARG
ARV	L-PEPTIDE LINKING
AS	DNA LINKING	DA
AS2	D-PEPTIDE LINKING
AS9	L-PEPTIDE LINKING
ASA	L-PEPTIDE LINKING	ASP
ASB	L-PEPTIDE LINKING	ASP
ASG	D-SACCHARIDE
ASI	L-PEPTIDE LINKING	ASP
ASK	L-PEPTIDE LINKING	ASP
ASL	L-PEPTIDE LINKING	ASP
ASM	L-PEPTIDE LINKING
ASN	L-PEPTIDE LINKING
ASO	SACCHARIDE
ASP	L-PEPTIDE LINKING
ASQ	L-PEPTIDE LINKING	ASP
ASU	DNA LINKING
ASX	L-PEPTIDE LINKING
ATD	DNA LINKING	DT
ATL	DNA LINKING	DT
ATM	DNA LINKING	DT
AVC	RNA LINKING	A
AVN	L-PEPTIDE LINKING
AXP	D-SACCHARIDE
AXR	D-SACCHARIDE
AYA	L-PEPTIDE LINKING	ALA
AYG	L-PEPTIDE LINKING	ALA	TYR	GLY
AYI	PEPTIDE-LIKE
AYQ	PEPTIDE-LIKE
AZ0	PEPTIDE-LIKE
AZK	L-PEPTIDE LINKING	LYS
AZS	L-PEPTIDE LINKING	SER
AZY	L-PEPTIDE LINKING	TYR
B0D	D-SACCHARIDE
B1F	L-PEPTIDE LINKING	PHE
B1P	DNA LINKING
B27	L-PEPTIDE COOH CARBOXY TERMINUS	THR
B2A	PEPTIDE-LIKE	ALA
B2F	PEPTIDE-LIKE	PHE
B2G	SACCHARIDE
B2I	PEPTIDE-LIKE	ILE
B2V	PEPTIDE-LIKE	VAL
B3A	L-PEPTIDE LINKING	ALA
B3D	PEPTIDE LINKING	ASP
B3E	L-PEPTIDE LINKING	GLU
B3K	L-PEPTIDE LINKING	LYS
B3L	L-PEPTIDE LINKING
B3M	L-PEPTIDE LINKING
B3Q	L-PEPTIDE LINKING
B3S	D-PEPTIDE LINKING
B3T	L-PEPTIDE LINKING
B3U	L-PEPTIDE LINKING	HIS
B3X	L-PEPTIDE LINKING	ASN
B3Y	L-PEPTIDE LINKING	TYR
B4G	SACCHARIDE
B6D	D-SACCHARIDE
B7C	DNA LINKING	DC
B8D	D-SACCHARIDE
B9D	D-SACCHARIDE
BAL	PEPTIDE-LIKE
BB6	PEPTIDE LINKING	CYS
BB7	PEPTIDE LINKING	CYS
BB9	PEPTIDE LINKING	CYS
BBC	L-PEPTIDE LINKING	CYS
BCC	PEPTIDE-LIKE
BCD	SACCHARIDE
BCS	L-PEPTIDE LINKING	CYS
BCX	L-PEPTIDE LINKING	CYS
BDG	D-SACCHARIDE
BDP	D-SACCHARIDE
BDR	SACCHARIDE
BE2	L-PEPTIDE LINKING
BEM	D-SACCHARIDE
BFD	L-PEPTIDE LINKING	ASP
BFP	SACCHARIDE
BG1	L-PEPTIDE LINKING	SER
BGC	SACCHARIDE
BGL	SACCHARIDE
BGM	DNA LINKING	DG
BGP	D-SACCHARIDE
BGS	D-SACCHARIDE
BHD	L-PEPTIDE LINKING	ASP
BHG	SACCHARIDE
BIF	L-PEPTIDE LINKING	PHE
BIL	L-PEPTIDE LINKING
BIU	L-PEPTIDE LINKING	ILE
BJH	L-PEPTIDE LINKING
BLE	PEPTIDE-LIKE	LEU
BLY	PEPTIDE-LIKE	LYS
BMA	D-SACCHARIDE
BMP	RNA LINKING
BMT	L-PEPTIDE LINKING	THR
BNG	SACCHARIDE
BNN	L-PEPTIDE LINKING	PHE
BNO	PEPTIDE-LIKE
BOE	DNA LINKING	DT
BOG	SACCHARIDE
BOR	PEPTIDE-LIKE	ARG
BPE	L-PEPTIDE LINKING	CYS
BRI	SACCHARIDE
BRU	DNA LINKING	DU
BSE	L-PEPTIDE LINKING	SER
BT5	RNA LINKING
BTA	L-PEPTIDE LINKING	LEU
BTC	L-PEPTIDE LINKING	CYS
BTK	L-PEPTIDE LINKING	LYS
BTR	L-PEPTIDE LINKING	TRP
BUC	L-PEPTIDE LINKING	CYS
BUG	'L-PEPTIDE LINKING'
BVP	DNA LINKING	DU
BXP	D-SACCHARIDE
BXX	D-SACCHARIDE
BXY	D-SACCHARIDE
BZG	DNA LINKING
C	RNA LINKING
C12	L-PEPTIDE LINKING	THR	TYR	GLY
C1T	L-PEPTIDE LINKING	CYS
C1X	L-PEPTIDE LINKING	LYS
C25	RNA LINKING	C
C2L	RNA LINKING	C
C2S	DNA LINKING	DC
C31	RNA LINKING	C
C32	DNA LINKING	DC
C34	DNA LINKING	DC
C36	DNA LINKING	DC
C37	DNA LINKING	DC
C38	DNA LINKING	DC
C3X	D-SACCHARIDE
C3Y	L-PEPTIDE LINKING	CYS
C42	DNA LINKING	DC
C43	RNA LINKING	C
C45	DNA LINKING	DC
C46	DNA LINKING	DC
C49	DNA LINKING	DC
C4R	L-PEPTIDE LINKING	CYS
C4S	DNA LINKING	DC
C4X	D-SACCHARIDE
C5C	L-PEPTIDE LINKING	CYS
C5X	D-SACCHARIDE
C66	L-PEPTIDE LINKING
C6C	L-PEPTIDE LINKING	CYS
C99	L-PEPTIDE LINKING	THR	PHE	GLY
CAB	'L-PEPTIDE LINKING'
CAF	L-PEPTIDE LINKING	CYS
CAL	PEPTIDE-LIKE
CAP	SACCHARIDE
CAR	DNA LINKING	DC
CAS	L-PEPTIDE LINKING	CYS
CAV	PEPTIDE-LIKE
CAY	L-PEPTIDE LINKING	CYS
CB2	DNA LINKING	DC
CBI	SACCHARIDE
CBR	DNA LINKING	DC
CBS	D-SACCHARIDE
CBV	RNA LINKING	C
CCC	RNA LINKING	C
CCL	D-PEPTIDE LINKING
CCS	L-PEPTIDE LINKING	CYS
CCY	L-PEPTIDE LINKING	CYS	TYR	GLY
CDE	L-PEPTIDE LINKING
CDR	SACCHARIDE
CDV	L-PEPTIDE LINKING
CDW	DNA LINKING	DC
CEA	L-PEPTIDE LINKING	CYS
CEG	D-SACCHARIDE
CFL	DNA LINKING	DC
CFY	L-PEPTIDE LINKING	PHE	CYS	TYR	GLY
CFZ	DNA LINKING	DC
CG1	RNA LINKING	G
CGA	L-PEPTIDE LINKING	GLU
CGF	D-SACCHARIDE
CGU	L-PEPTIDE LINKING	GLU
CH	RNA LINKING	C
CH6	L-PEPTIDE LINKING	MET	TYR	GLY
CH7	L-PEPTIDE LINKING	LYS	TYR	GLY
CHF	PEPTIDE-LIKE
CHG	L-PEPTIDE LINKING
CHO	D-SACCHARIDE
CHP	L-PEPTIDE LINKING	GLY
CHS	PEPTIDE-LIKE
CIR	L-PEPTIDE LINKING	ARG
CJO	L-PEPTIDE LINKING	GLY	TYR	GLY
CLB	D-PEPTIDE LINKING
CLD	D-PEPTIDE LINKING
CLE	L-PEPTIDE LINKING	LEU
CLG	L-PEPTIDE LINKING	LYS
CLH	L-PEPTIDE LINKING	LYS
CLV	L-PEPTIDE LINKING	ALA	PHE	GLY
CM0	RNA LINKING
CME	L-PEPTIDE LINKING	CYS
CMH	L-PEPTIDE LINKING	CYS
CML	L-PEPTIDE LINKING	CYS
CMR	DNA LINKING	DC
CMT	L-PEPTIDE LINKING	CYS
CNU	RNA LINKING	U
CP1	DNA LINKING	DC
CPC	L-PEPTIDE LINKING
CPI	L-PEPTIDE LINKING
CPN	PEPTIDE-LIKE
CQR	L-PEPTIDE LINKING	GLY	TYR	GLY
CR0	L-PEPTIDE LINKING	THR	LEU	GLY
CR1	D-SACCHARIDE
CR2	L-PEPTIDE LINKING	GLY	TYR	GLY
CR5	L-PEPTIDE LINKING	GLY
CR6	D-SACCHARIDE
CR7	L-PEPTIDE LINKING	LYS	TYR	GLY
CR8	L-PEPTIDE LINKING	HIS	TYR	GLY
CRA	D-SACCHARIDE
CRF	L-PEPTIDE LINKING	THR	TRP	GLY
CRG	L-PEPTIDE LINKING	THR	HIS	GLY
CRK	L-PEPTIDE LINKING	MET	TYR	GLY
CRO	L-PEPTIDE LINKING	GLY	TYR	GLY
CRQ	L-PEPTIDE LINKING	GLN	TYR	GLY
CRU	L-PEPTIDE LINKING	GLU	TYR	GLY
CRW	L-PEPTIDE LINKING	ALA	SER	GLY
CRX	L-PEPTIDE LINKING	ALA	SER	GLY
CS0	L-PEPTIDE LINKING	CYS
CS1	L-PEPTIDE LINKING	CYS
CS3	L-PEPTIDE LINKING	CYS
CS4	L-PEPTIDE LINKING	CYS
CS8	RNA LINKING
CSA	L-PEPTIDE LINKING	CYS
CSB	L-PEPTIDE LINKING	CYS
CSD	L-PEPTIDE LINKING	CYS
CSE	L-PEPTIDE LINKING	CYS
CSF	RNA LINKING	C
CSH	L-PEPTIDE LINKING	SER	HIS	GLY
CSI	L-PEPTIDE LINKING	GLY
CSJ	L-PEPTIDE LINKING	CYS
CSL	DNA LINKING	DC
CSO	L-PEPTIDE LINKING	CYS
CSP	L-PEPTIDE LINKING	CYS
CSR	L-PEPTIDE LINKING	CYS
CSS	L-PEPTIDE LINKING	CYS
CSU	L-PEPTIDE LINKING	CYS
CSW	L-PEPTIDE LINKING	CYS
CSX	L-PEPTIDE LINKING	CYS
CSY	L-PEPTIDE LINKING	SER	TYR	GLY
CSZ	L-PEPTIDE LINKING	CYS
CTE	L-PEPTIDE LINKING	TRP
CTG	DNA LINKING	DT
CTH	L-PEPTIDE LINKING	THR
CTO	D-SACCHARIDE
CTR	D-SACCHARIDE
CTT	D-SACCHARIDE 1,4 AND 1,4 LINKING
CUC	L-PEPTIDE LINKING
CUD	D-PEPTIDE LINKING
CWR	L-PEPTIDE LINKING	SER
CXM	L-PEPTIDE LINKING	MET
CY0	L-PEPTIDE LINKING	CYS
CY1	L-PEPTIDE LINKING	CYS
CY3	L-PEPTIDE LINKING	CYS
CY4	L-PEPTIDE LINKING	CYS
CYA	L-PEPTIDE LINKING	CYS
CYD	L-PEPTIDE COOH CARBOXY TERMINUS	CYS
CYF	L-PEPTIDE LINKING	CYS
CYG	L-PEPTIDE LINKING	CYS
CYJ	L-PEPTIDE LINKING
CYM	L-PEPTIDE LINKING	CYS
CYQ	L-PEPTIDE LINKING	CYS
CYR	L-PEPTIDE LINKING	CYS
CYS	L-PEPTIDE LINKING
CZ2	L-PEPTIDE LINKING	CYS
CZO	L-PEPTIDE LINKING	GLY	TYR	GLY
CZZ	L-PEPTIDE LINKING	CYS
D11	D-PEPTIDE LINKING
D1P	DNA LINKING
D3	DNA LINKING
D33	DNA LINKING
D3P	D-PEPTIDE LINKING
D3T	DNA OH 3 PRIME TERMINUS	DT
D4M	DNA LINKING	DT
D4P	L-PEPTIDE LINKING
D6G	SACCHARIDE
DA	DNA LINKING
DA2	L-PEPTIDE LINKING
DAB	L-PEPTIDE LINKING	ALA
DAF	D-SACCHARIDE
DAG	D-SACCHARIDE
DAH	L-PEPTIDE LINKING	PHE
DAL	D-PEPTIDE LINKING
DAM	'PEPTIDE LINKING'
DAR	D-PEPTIDE LINKING
DAS	D-PEPTIDE LINKING
DBB	D-PEPTIDE LINKING
DBM	RNA LINKING
DBS	L-PEPTIDE LINKING	SER
DBU	PEPTIDE LINKING	ALA
DBY	L-PEPTIDE LINKING	TYR
DBZ	L-PEPTIDE LINKING	ALA
DC	DNA LINKING
DC2	L-PEPTIDE LINKING	CYS
DCG	DNA LINKING	DG
DCL	PEPTIDE-LIKE
DCT	DNA LINKING	DC
DCY	D-PEPTIDE LINKING
DDA	D-SACCHARIDE
DDB	D-SACCHARIDE
DDE	L-PEPTIDE LINKING	HIS
DDG	DNA LINKING	DG
DDL	D-SACCHARIDE
DDN	DNA LINKING	DU
DDX	DNA LINKING
DDZ	L-PEPTIDE LINKING	ALA
DEL	SACCHARIDE
DFC	DNA LINKING	DC
DFG	DNA LINKING	DG
DFI	L-PEPTIDE LINKING
DFO	L-PEPTIDE LINKING
DFR	D-SACCHARIDE
DFT	DNA LINKING
DFX	SACCHARIDE
DG	DNA LINKING
DG0	SACCHARIDE
DGC	D-SACCHARIDE
DGD	SACCHARIDE
DGH	D-PEPTIDE LINKING
DGI	DNA LINKING	DG
DGL	D-PEPTIDE LINKING
DGM	D-SACCHARIDE
DGN	D-PEPTIDE LINKING
DGS	D-SACCHARIDE
DHA	PEPTIDE LINKING	ALA
DHI	D-PEPTIDE LINKING
DHL	L-PEPTIDE LINKING
DHN	L-PEPTIDE LINKING	VAL
DHP	L-PEPTIDE LINKING
DHU	RNA LINKING	U
DHV	D-PEPTIDE LINKING
DI	DNA LINKING
DIG	SACCHARIDE
DIL	D-PEPTIDE LINKING
DIR	L-PEPTIDE LINKING	ARG
DIV	D-PEPTIDE LINKING
DLE	D-PEPTIDE LINKING
DLF	L-SACCHARIDE
DLG	SACCHARIDE
DLS	L-PEPTIDE LINKING	LYS
DLY	D-PEPTIDE LINKING
DM0	L-PEPTIDE LINKING	LYS
DMH	L-PEPTIDE LINKING	ASN
DMK	L-PEPTIDE LINKING	ASP
DMT	L-PEPTIDE LINKING
DMU	D-SACCHARIDE
DN	DNA LINKING
DNE	D-PEPTIDE LINKING
DNG	D-PEPTIDE LINKING
DNL	L-PEPTIDE LINKING	LYS
DNM	D-PEPTIDE LINKING
DNO	D-SACCHARIDE
DNP	L-PEPTIDE LINKING	ALA
DNR	DNA LINKING	DC
DNS	L-PEPTIDE LINKING	LYS
DO2	'L-PEPTIDE LINKING'
DOA	L-PEPTIDE LINKING
DOC	DNA LINKING	DC
DOH	L-PEPTIDE LINKING	ASP
DOM	D-SACCHARIDE
DON	L-PEPTIDE LINKING	LEU
DP5	SACCHARIDE
DPB	DNA LINKING	DT
DPL	L-PEPTIDE LINKING	PRO
DPN	D-PEPTIDE LINKING
DPP	L-PEPTIDE LINKING	ALA
DPQ	L-PEPTIDE LINKING	TYR
DPR	D-PEPTIDE LINKING
DPY	DNA LINKING
DQQ	D-SACCHARIDE
DQR	D-SACCHARIDE
DR2	SACCHARIDE
DR3	SACCHARIDE
DR4	SACCHARIDE
DRI	D-SACCHARIDE
DRM	DNA LINKING	DU
DRP	DNA LINKING
DRT	DNA LINKING	DT
DRZ	DNA LINKING
DSE	D-PEPTIDE LINKING
DSG	D-PEPTIDE LINKING
DSN	D-PEPTIDE LINKING
DSP	D-PEPTIDE LINKING
DSR	D-SACCHARIDE
DT	DNA LINKING
DT6	D-SACCHARIDE
DTH	D-PEPTIDE LINKING
DTR	D-PEPTIDE LINKING
DTY	D-PEPTIDE LINKING
DU	DNA LINKING
DVA	D-PEPTIDE LINKING
DXD	DNA LINKING
DXN	DNA LINKING
DYG	L-PEPTIDE LINKING	ASP	TYR	GLY
DYS	L-PEPTIDE LINKING	CYS
DZM	DNA LINKING	DA
E	DNA LINKING	DA
E13	PEPTIDE-LIKE
E14	PEPTIDE-LIKE
E15	PEPTIDE-LIKE
E16	PEPTIDE-LIKE
E17	PEPTIDE-LIKE
E19	PEPTIDE-LIKE
E1X	DNA LINKING	DA
E4P	SACCHARIDE
EAG	D-SACCHARIDE
EBG	D-SACCHARIDE
ECX	L-PEPTIDE LINKING	CYS
EDA	DNA LINKING	DA
EDC	DNA LINKING	DG
EFC	L-PEPTIDE LINKING	CYS
EHP	L-PEPTIDE LINKING	PHE
EIT	DNA LINKING	DT
EJT	SACCHARIDE
ENA	RNA LINKING
ENP	RNA LINKING
ENQ	RNA LINKING
EOV	PEPTIDE-LIKE
EP2	PEPTIDE-LIKE
EPG	D-SACCHARIDE
ERE	SACCHARIDE	4-EPI-VANCOSAMINE
ERI	SACCHARIDE
ESB	L-PEPTIDE LINKING	TYR
ESC	L-PEPTIDE LINKING	MET
ETA	'L-PEPTIDE COOH CARBOXY TERMINUS'
EXY	L-PEPTIDE LINKING	LEU
EYS	L-PEPTIDE LINKING
F1P	SACCHARIDE
F2F	L-PEPTIDE LINKING	PHE
F6P	SACCHARIDE
FA2	DNA LINKING	DA
FA5	RNA LINKING
FAG	DNA LINKING
FAI	RNA LINKING
FBP	SACCHARIDE
FC0	L-PEPTIDE COOH CARBOXY TERMINUS	PHE
FCA	D-SACCHARIDE
FCB	D-SACCHARIDE
FCL	L-PEPTIDE LINKING	PHE
FCT	D-SACCHARIDE
FDG	DNA LINKING	DG
FDP	D-SACCHARIDE
FDQ	D-SACCHARIDE
FFC	D-SACCHARIDE
FFD	DNA LINKING
FFM	L-PEPTIDE LINKING	CYS
FGA	D-PEPTIDE LINKING
FGK	PEPTIDE-LIKE
FGL	L-PEPTIDE LINKING	GLY
FGP	L-PEPTIDE LINKING	SER
FH7	PEPTIDE LINKING
FHL	L-PEPTIDE LINKING
FHO	L-PEPTIDE LINKING	LYS
FHU	RNA LINKING	U
FIX	D-SACCHARIDE
FLA	L-PEPTIDE LINKING	ALA
FLE	L-PEPTIDE LINKING	LEU
FLT	L-PEPTIDE LINKING	TYR
FME	L-PEPTIDE LINKING	MET
FMG	DNA LINKING	DG
FMU	RNA LINKING
FOE	L-PEPTIDE LINKING	CYS
FOG	PEPTIDE-LIKE
FOX	DNA LINKING	DG
FP9	L-PEPTIDE LINKING	PRO
FPR	L-PEPTIDE LINKING
FRD	L-PEPTIDE LINKING
FRU	SACCHARIDE
FT6	L-PEPTIDE LINKING	TRP
FTR	L-PEPTIDE LINKING	TRP
FTY	L-PEPTIDE LINKING	TYR
FU4	D-SACCHARIDE
FUB	L-SACCHARIDE
FUC	SACCHARIDE
FUD	D-SACCHARIDE
FUL	L-SACCHARIDE
FXP	D-SACCHARIDE
FYI	PEPTIDE-LIKE
FYQ	PEPTIDE-LIKE
FZN	L-PEPTIDE LINKING	LYS
G	RNA LINKING
G01	D-PEPTIDE NH3 AMINO TERMINUS	GLU
G16	D-SACCHARIDE
G1P	D-SACCHARIDE
G25	RNA LINKING	G
G2F	SACCHARIDE
G2L	RNA LINKING	G
G2S	DNA LINKING	DG
G31	DNA LINKING	DG
G32	DNA LINKING	DG
G33	DNA LINKING	DG
G35	DNA LINKING
G36	DNA LINKING	DG
G38	DNA LINKING	DG
G3I	SACCHARIDE
G42	DNA LINKING	DG
G46	RNA LINKING	G
G47	DNA LINKING	DG
G48	RNA LINKING	G
G49	DNA LINKING	DG
G4D	D-SACCHARIDE
G4P	RNA LINKING
G4S	D-SACCHARIDE
G6D	D-SACCHARIDE
G6P	D-SACCHARIDE
G6S	D-SACCHARIDE
G7M	RNA LINKING	G
GAC	SACCHARIDE
GAD	SACCHARIDE
GAL	D-SACCHARIDE
GAO	RNA LINKING	G
GAU	L-PEPTIDE LINKING	GLU
GC1	L-SACCHARIDE
GC4	D-SACCHARIDE
GCD	D-SACCHARIDE
GCK	DNA LINKING	DC
GCM	L-PEPTIDE LINKING
GCN	D-SACCHARIDE
GCO	SACCHARIDE
GCS	D-SACCHARIDE
GCT	SACCHARIDE
GCU	D-SACCHARIDE
GCV	D-SACCHARIDE
GCW	D-SACCHARIDE
GDP	RNA LINKING	G
GDR	DNA LINKING	DG
GE1	D-SACCHARIDE
GF2	DNA LINKING	DG
GFG	D-SACCHARIDE
GFL	DNA LINKING	DG
GFP	D-SACCHARIDE
GGL	L-PEPTIDE LINKING	GLU
GH3	RNA LINKING	G
GHC	L-PEPTIDE LINKING	GLU
GHG	L-PEPTIDE LINKING	GLN
GHP	D-PEPTIDE LINKING
GHW	L-PEPTIDE LINKING	GLU
GL0	D-SACCHARIDE
GL2	D-SACCHARIDE
GL3	L-PEPTIDE LINKING	GLY
GL5	D-SACCHARIDE
GL6	SACCHARIDE
GL7	D-SACCHARIDE
GL9	D-SACCHARIDE
GLA	D-SACCHARIDE
GLB	D-SACCHARIDE
GLC	SACCHARIDE
GLD	SACCHARIDE
GLF	D-SACCHARIDE
GLG	SACCHARIDE
GLH	L-PEPTIDE LINKING	GLN
GLM	L-PEPTIDE LINKING
GLN	L-PEPTIDE LINKING
GLO	D-SACCHARIDE
GLP	SACCHARIDE
GLQ	L-PEPTIDE LINKING	GLU
GLS	D-SACCHARIDE
GLT	D-SACCHARIDE
GLU	L-PEPTIDE LINKING
GLW	SACCHARIDE
GLX	L-PEPTIDE LINKING
GLY	PEPTIDE LINKING
GLZ	L-PEPTIDE LINKING	GLY
GMA	L-PEPTIDE LINKING	GLU
GME	L-PEPTIDE LINKING	GLU
GMH	D-SACCHARIDE
GMS	DNA LINKING	DG
GMU	DNA LINKING	DU
GN1	D-SACCHARIDE
GN7	DNA LINKING	DG
GND	L-PEPTIDE LINKING
GNE	DNA LINKING
GOM	RNA LINKING	G
GP1	SACCHARIDE
GP4	SACCHARIDE
GPH	D-SACCHARIDE
GPL	L-PEPTIDE LINKING	LYS
GPM	SACCHARIDE
GPN	PEPTIDE-LIKE
GS	DNA LINKING	DG
GS1	D-SACCHARIDE
GS4	D-SACCHARIDE
GSA	SACCHARIDE
GSC	L-PEPTIDE LINKING	GLY
GSD	D-SACCHARIDE
GSR	DNA LINKING	DG
GSS	DNA LINKING	DG
GSU	L-PEPTIDE LINKING	GLU
GT9	L-PEPTIDE LINKING	CYS
GTE	SACCHARIDE
GTH	SACCHARIDE
GTP	RNA LINKING	G
GTR	SACCHARIDE
GTZ	SACCHARIDE
GU0	D-SACCHARIDE 1,4 AND 1,4 LINKING
GU1	D-SACCHARIDE 1,4 AND 1,4 LINKING
GU2	L-SACCHARIDE 1,4 AND 1,4 LINKING
GU3	D-SACCHARIDE
GU4	D-SACCHARIDE 1,4 AND 1,4 LINKING
GU5	D-SACCHARIDE 1,4 AND 1,4 LINKING
GU6	D-SACCHARIDE 1,4 AND 1,4 LINKING
GU8	D-SACCHARIDE 1,4 AND 1,4 LINKING
GU9	D-SACCHARIDE 1,4 AND 1,4 LINKING
GUP	L-SACCHARIDE
GVE	PEPTIDE-LIKE
GVL	L-PEPTIDE LINKING
GX1	DNA LINKING	DG
GYC	L-PEPTIDE LINKING	CYS	TYR	GLY
GYP	D-SACCHARIDE
GYS	L-PEPTIDE LINKING	SER	TYR	GLY
GYV	SACCHARIDE
H2P	SACCHARIDE
H2U	RNA LINKING	U
H5M	L-PEPTIDE LINKING	PRO
HAC	L-PEPTIDE LINKING	ALA
HAO	PEPTIDE-LIKE
HAQ	PEPTIDE-LIKE
HAR	L-PEPTIDE LINKING	ARG
HBN	L-PEPTIDE LINKING	HIS
HCS	L-PEPTIDE LINKING
HDL	D-SACCHARIDE
HDP	DNA LINKING	DU
HEU	DNA LINKING	DU
HF2	PEPTIDE-LIKE
HFA	L-PEPTIDE LINKING
HGL	L-PEPTIDE LINKING
HHI	PEPTIDE LINKING	HIS
HHK	L-PEPTIDE LINKING	ALA	LYS
HIA	L-PEPTIDE LINKING	HIS
HIC	L-PEPTIDE LINKING	HIS
HIP	L-PEPTIDE LINKING	HIS
HIQ	L-PEPTIDE LINKING	HIS
HIS	L-PEPTIDE LINKING
HL2	L-PEPTIDE LINKING	LEU
HLU	L-PEPTIDE LINKING	LEU
HMF	L-PEPTIDE LINKING	ALA
HMR	L-PEPTIDE LINKING	ARG
HMS	SACCHARIDE
HNC	L-PEPTIDE LINKING	CYS
HOL	DNA LINKING
HOX	L-PEPTIDE LINKING	PHE
HP0	PEPTIDE-LIKE
HPC	L-PEPTIDE LINKING	PHE
HPE	L-PEPTIDE LINKING	PHE
HPH	PEPTIDE-LIKE
HPQ	L-PEPTIDE LINKING	PHE
HQA	L-PEPTIDE LINKING	ALA
HRG	L-PEPTIDE LINKING	ARG
HRP	L-PEPTIDE LINKING	TRP
HS8	L-PEPTIDE LINKING	HIS
HS9	L-PEPTIDE LINKING	HIS
HSD	SACCHARIDE
HSE	L-PEPTIDE LINKING	SER
HSG	SACCHARIDE
HSH	SACCHARIDE
HSL	L-PEPTIDE LINKING	SER
HSO	L-PEPTIDE LINKING	HIS
HSQ	SACCHARIDE
HSR	SACCHARIDE
HSU	SACCHARIDE
HSX	SACCHARIDE
HSY	SACCHARIDE
HSZ	SACCHARIDE
HTI	L-PEPTIDE LINKING	CYS
HTN	D-PEPTIDE LINKING
HTR	L-PEPTIDE LINKING	TRP
HV5	L-PEPTIDE LINKING	ALA
HV8	PEPTIDE-LIKE
HVA	L-PEPTIDE LINKING	VAL
HY3	L-PEPTIDE LINKING	PRO
HYP	L-PEPTIDE LINKING	PRO
HZP	L-PEPTIDE LINKING	PRO
I	RNA LINKING
I2M	L-PEPTIDE LINKING	ILE
I58	L-PEPTIDE LINKING	LYS
I5C	DNA LINKING	DC
IAB	SACCHARIDE
IAM	L-PEPTIDE LINKING	ALA
IAR	PEPTIDE LINKING	ARG
IAS	L-PEPTIDE LINKING	ASP
IC	RNA LINKING	C
IDG	L-SACCHARIDE
IDR	L-SACCHARIDE
IDS	SACCHARIDE
IDT	L-SACCHARIDE
IDU	L-SACCHARIDE
IDX	L-SACCHARIDE
IEL	L-PEPTIDE LINKING	LYS
IEY	L-PEPTIDE LINKING	HIS	TYR	GLY
IG	RNA LINKING	G
IGL	L-PEPTIDE LINKING	GLY
IGU	DNA LINKING	DG
IHN	PEPTIDE-LIKE
IIC	L-PEPTIDE LINKING	SER	HIS	GLY
IIL	L-PEPTIDE LINKING	ILE
ILE	L-PEPTIDE LINKING
ILG	L-PEPTIDE LINKING	GLU
ILX	L-PEPTIDE LINKING	ILE
IMC	DNA LINKING	DC
IMK	D-SACCHARIDE
IML	L-PEPTIDE LINKING	ILE
IN1	SACCHARIDE
IOY	D-PEPTIDE LINKING
IPG	L-PEPTIDE LINKING	GLY
IPN	DNA LINKING
IPT	D-SACCHARIDE
IRN	RNA LINKING
IT1	L-PEPTIDE LINKING	LYS
IU	RNA LINKING	U
IYR	L-PEPTIDE LINKING	TYR
IYT	D-PEPTIDE LINKING
JW5	RNA LINKING
K1R	L-PEPTIDE LINKING	CYS
KAG	RNA LINKING	G
KBE	L-PEPTIDE LINKING	LYS
KBG	D-SACCHARIDE
KCX	L-PEPTIDE LINKING	LYS
KDA	D-SACCHARIDE
KDO	D-SACCHARIDE
KGC	L-PEPTIDE LINKING	LYS
KO1	D-SACCHARIDE
KO2	D-SACCHARIDE
KOR	L-PEPTIDE LINKING	MET
KPI	L-PEPTIDE LINKING	LYS
KST	L-PEPTIDE LINKING	LYS
KYN	L-PEPTIDE LINKING
KYQ	L-PEPTIDE LINKING	LYS
L2A	L-PEPTIDE LINKING
L3A	PEPTIDE-LIKE
L3O	L-PEPTIDE LINKING	LEU
L6S	L-SACCHARIDE
LA2	L-PEPTIDE LINKING	LYS
LAA	L-PEPTIDE LINKING	ASP
LAG	D-SACCHARIDE 1,4 AND 1,4 LINKING
LAK	SACCHARIDE
LAL	L-PEPTIDE LINKING	ALA
LAT	SACCHARIDE
LB2	D-SACCHARIDE
LBT	SACCHARIDE
LBY	L-PEPTIDE LINKING	LYS
LC	RNA LINKING	C
LCA	RNA LINKING	A
LCC	DNA LINKING
LCG	DNA LINKING	DG
LCH	DNA LINKING
LCK	L-PEPTIDE LINKING	LYS
LCX	L-PEPTIDE LINKING	LYS
LDH	L-PEPTIDE LINKING	LYS
LDY	D-SACCHARIDE
LE1	L-PEPTIDE LINKING	VAL
LED	L-PEPTIDE LINKING	LEU
LEF	L-PEPTIDE LINKING	LEU
LEH	L-PEPTIDE LINKING	LEU
LEI	D-PEPTIDE LINKING
LEM	L-PEPTIDE LINKING	LEU
LEN	L-PEPTIDE COOH CARBOXY TERMINUS	LEU
LEP	PEPTIDE-LIKE
LET	L-PEPTIDE LINKING
LEU	L-PEPTIDE LINKING
LG	RNA LINKING	G
LGC	SACCHARIDE
LGP	DNA LINKING	DG
LGU	L-SACCHARIDE
LHC	L-PEPTIDE LINKING
LHU	RNA LINKING	U
LKC	DNA LINKING
LLP	L-PEPTIDE LINKING	LYS
LLY	L-PEPTIDE LINKING	LYS
LM2	D-SACCHARIDE 1,4 AND 1,4 LINKING
LME	L-PEPTIDE LINKING	GLU
LMQ	L-PEPTIDE LINKING	GLN
LMS	RNA LINKING
LMT	D-SACCHARIDE
LMU	D-SACCHARIDE
LNT	PEPTIDE-LIKE
LOL	PEPTIDE-LIKE
LOV	PEPTIDE-LIKE
LOX	D-SACCHARIDE
LP6	L-PEPTIDE LINKING	LYS
LPD	L-PEPTIDE LINKING	PRO
LPG	L-PEPTIDE LINKING	GLY
LPL	L-PEPTIDE LINKING
LPS	L-PEPTIDE LINKING	SER
LSO	L-PEPTIDE LINKING
LTA	L-PEPTIDE LINKING
LTR	L-PEPTIDE LINKING	TRP
LVG	L-PEPTIDE LINKING	GLY
LVN	L-PEPTIDE LINKING	VAL
LWY	L-PEPTIDE NH3 AMINO TERMINUS	PRO
LXB	D-SACCHARIDE
LXZ	D-SACCHARIDE
LYM	L-PEPTIDE LINKING	LYS
LYN	L-PEPTIDE LINKING	LYS
LYR	L-PEPTIDE LINKING	LYS
LYS	L-PEPTIDE LINKING
LYX	L-PEPTIDE LINKING	LYS
LYZ	L-PEPTIDE LINKING	LYS
M0H	L-PEPTIDE LINKING	CYS
M1G	DNA LINKING	DG
M2G	RNA LINKING	G
M2L	L-PEPTIDE LINKING	LYS
M2S	L-PEPTIDE LINKING	MET
M3L	L-PEPTIDE LINKING	LYS
M3M	D-SACCHARIDE
M3R	L-PEPTIDE NH3 AMINO TERMINUS	LYS
M5M	RNA LINKING	C
M6P	D-SACCHARIDE
M8C	D-SACCHARIDE
MA	L-PEPTIDE COOH CARBOXY TERMINUS	ALA
MA1	D-SACCHARIDE
MA2	D-SACCHARIDE
MA3	D-SACCHARIDE
MA6	RNA LINKING	A
MA7	DNA LINKING	DA
MAA	'L-PEPTIDE LINKING'	ALA
MAB	SACCHARIDE
MAD	RNA LINKING	A
MAG	D-SACCHARIDE
MAI	L-PEPTIDE LINKING	ARG
MAL	D-SACCHARIDE
MAN	D-SACCHARIDE
MAT	L-SACCHARIDE
MAV	SACCHARIDE
MAW	L-SACCHARIDE
MBG	SACCHARIDE
MBQ	L-PEPTIDE LINKING	TYR
MBZ	DNA LINKING
MC1	L-PEPTIDE LINKING	SER
MCG	L-PEPTIDE LINKING
MCL	L-PEPTIDE LINKING	LYS
MCS	L-PEPTIDE LINKING	CYS
MCY	DNA LINKING	DC
MDA	D-SACCHARIDE
MDH	PEPTIDE LINKING
MDM	D-SACCHARIDE
MDO	L-PEPTIDE LINKING	ALA	SER	GLY
MDP	D-SACCHARIDE
MDR	DNA LINKING
ME0	L-PEPTIDE LINKING	MET
ME6	DNA LINKING	DC
MEA	'L-PEPTIDE LINKING'	PHE
MED	D-PEPTIDE LINKING
MEG	L-PEPTIDE LINKING	GLU
MEN	L-PEPTIDE LINKING	ASN
MEP	RNA LINKING	U
MEQ	L-PEPTIDE LINKING	GLN
MET	L-PEPTIDE LINKING
MEU	'PEPTIDE LINKING'	GLY
MF3	L-PEPTIDE LINKING
MFA	L-SACCHARIDE
MFB	L-SACCHARIDE
MFC	L-PEPTIDE LINKING	GLY	TYR	GLY
MFU	L-SACCHARIDE
MG1	DNA LINKING	DG
MGA	D-SACCHARIDE
MGG	L-PEPTIDE LINKING	ARG
MGL	SACCHARIDE
MGN	L-PEPTIDE LINKING	GLN
MGQ	RNA LINKING	A
MGV	RNA LINKING	G
MGY	L-PEPTIDE LINKING	GLY
MH1	L-PEPTIDE LINKING	HIS
MH6	L-PEPTIDE LINKING	SER
MHE	L-PEPTIDE NH3 AMINO TERMINUS
MHL	L-PEPTIDE LINKING	LEU
MHO	L-PEPTIDE LINKING	MET
MHS	L-PEPTIDE LINKING	HIS
MHU	L-PEPTIDE LINKING	PHE
MHV	L-PEPTIDE LINKING
MHW	PEPTIDE LINKING
MIA	RNA LINKING	A
MID	PEPTIDE-LIKE
MIR	L-PEPTIDE LINKING	SER
MIS	L-PEPTIDE LINKING	SER
MIT	PEPTIDE-LIKE
MK8	L-PEPTIDE LINKING	LEU
ML3	L-PEPTIDE LINKING	LYS
MLE	L-PEPTIDE LINKING	LEU
MLL	L-PEPTIDE LINKING	LEU
MLY	L-PEPTIDE LINKING	LYS
MLZ	L-PEPTIDE LINKING	LYS
MMA	SACCHARIDE
MME	L-PEPTIDE LINKING	MET
MMN	SACCHARIDE
MMT	DNA LINKING	DT
MND	D-PEPTIDE LINKING
MNL	L-PEPTIDE LINKING	LEU
MNU	RNA LINKING	U
MNV	L-PEPTIDE LINKING	VAL
MOD	L-PEPTIDE LINKING
MP8	L-PEPTIDE LINKING	PRO
MPH	L-PEPTIDE LINKING
MPJ	L-PEPTIDE LINKING
MPQ	L-PEPTIDE LINKING	GLY
MRG	DNA LINKING	DG
MRP	L-SACCHARIDE
MSA	L-PEPTIDE LINKING	GLY
MSE	L-PEPTIDE LINKING	MET
MSL	L-PEPTIDE LINKING	MET
MSO	L-PEPTIDE LINKING	MET
MSP	L-PEPTIDE LINKING
MT2	L-PEPTIDE LINKING	MET
MT5	?
MTR	DNA LINKING	DT
MTT	D-SACCHARIDE
MTU	RNA LINKING	A
MTY	L-PEPTIDE LINKING	TYR
MUG	D-SACCHARIDE
MVA	L-PEPTIDE LINKING	VAL
MXY	SACCHARIDE
MYN	L-PEPTIDE LINKING	ARG
N	RNA LINKING
N10	L-PEPTIDE LINKING	SER
N2C	L-PEPTIDE LINKING
N31	PEPTIDE-LIKE
N5I	DNA LINKING
N5M	RNA LINKING	C
N6G	RNA LINKING	G
N7P	L-PEPTIDE LINKING	PRO
NA8	L-PEPTIDE LINKING	ALA
NAA	D-SACCHARIDE
NAG	D-SACCHARIDE
NAL	L-PEPTIDE LINKING	ALA
NAM	L-PEPTIDE LINKING	ALA
NBG	D-SACCHARIDE
NBQ	L-PEPTIDE LINKING	TYR
NC1	L-PEPTIDE LINKING	SER
NCB	L-PEPTIDE LINKING	ALA
NCX	DNA LINKING
NCY	L-PEPTIDE LINKING
NDF	D-PEPTIDE LINKING
NDG	D-SACCHARIDE
NDN	DNA LINKING	DU
NDU	DNA LINKING	DU
NED	D-SACCHARIDE
NEM	L-PEPTIDE LINKING	HIS
NEP	L-PEPTIDE LINKING	HIS
NF2	RNA LINKING
NFA	L-PEPTIDE LINKING	PHE
NG1	SACCHARIDE
NG6	D-SACCHARIDE
NGA	D-SACCHARIDE
NGC	D-SACCHARIDE
NGL	SACCHARIDE
NGS	D-SACCHARIDE
NGY	D-SACCHARIDE
NHF	D-SACCHARIDE
NHL	D-PEPTIDE LINKING
NIY	L-PEPTIDE LINKING	TYR
NKS	L-PEPTIDE LINKING
NLE	L-PEPTIDE LINKING	LEU
NLN	L-PEPTIDE LINKING	LEU
NLO	L-PEPTIDE LINKING	LEU
NLP	L-PEPTIDE LINKING	LEU
NLQ	L-PEPTIDE LINKING	GLN
NMC	L-PEPTIDE LINKING	GLY
NMM	L-PEPTIDE LINKING	ARG
NMS	DNA LINKING	DT
NMT	DNA LINKING	DT
NNH	L-PEPTIDE LINKING	ARG
NOR	PEPTIDE-LIKE
NOT	L-PEPTIDE LINKING	LEU
NP3	DNA LINKING
NPH	L-PEPTIDE LINKING	CYS
NRG	L-PEPTIDE LINKING
NRI	DNA LINKING
NRP	L-PEPTIDE LINKING	LEU	TYR	GLY
NRQ	L-PEPTIDE LINKING	MET	TYR	GLY
NSK	L-PEPTIDE LINKING
NTF	D-SACCHARIDE
NTO	SACCHARIDE
NTP	SACCHARIDE
NTY	L-PEPTIDE LINKING	TYR
NVA	L-PEPTIDE LINKING	VAL
NXD	D-SACCHARIDE
NYB	L-PEPTIDE LINKING	CYS
NYC	L-PEPTIDE LINKING	THR	TRP	GLY
NYG	L-PEPTIDE LINKING	ASN	TYR	GLY
NYM	DNA LINKING
NYS	L-PEPTIDE LINKING	CYS
NYT	D-SACCHARIDE
NZH	L-PEPTIDE LINKING	HIS
O12	L-PEPTIDE LINKING
O2C	DNA LINKING
O2G	RNA LINKING	G
OAD	RNA LINKING
OAS	L-PEPTIDE LINKING	SER
OBF	L-PEPTIDE LINKING
OBS	L-PEPTIDE LINKING
OCS	L-PEPTIDE LINKING	CYS
OCY	L-PEPTIDE LINKING	CYS
ODA	PEPTIDE-LIKE
ODP	RNA LINKING
ODS	PEPTIDE-LIKE
OGX	DNA LINKING	DG
OHI	L-PEPTIDE LINKING	HIS
OHS	L-PEPTIDE LINKING	ASP
OIC	L-PEPTIDE LINKING
OIP	DNA LINKING	DI
OLE	L-PEPTIDE LINKING
OLT	L-PEPTIDE LINKING	THR
OLZ	L-PEPTIDE LINKING	SER
OMC	RNA LINKING	C
OMG	RNA LINKING	G
OMH	L-PEPTIDE LINKING	SER
OMT	L-PEPTIDE LINKING	MET
OMU	RNA LINKING	U
OMX	L-PEPTIDE LINKING	TYR
OMY	L-PEPTIDE LINKING	TYR
ONE	RNA LINKING	U
ONL	L-PEPTIDE LINKING
OPG	SACCHARIDE
OPM	SACCHARIDE
OPR	L-PEPTIDE LINKING	ARG
ORD	D-PEPTIDE LINKING
ORN	L-PEPTIDE LINKING	ALA
ORP	SACCHARIDE
ORQ	L-PEPTIDE LINKING	ARG
OSE	L-PEPTIDE LINKING	SER
OTB	L-PEPTIDE LINKING
OTH	L-PEPTIDE LINKING	THR
OTY	L-PEPTIDE LINKING	TYR
OX2	D-SACCHARIDE
OXX	L-PEPTIDE LINKING	ASP
OZT	L-PEPTIDE NH3 AMINO TERMINUS
P	DNA LINKING	DG
P1L	L-PEPTIDE LINKING	CYS
P1P	RNA LINKING
P2Q	L-PEPTIDE LINKING	TYR
P2T	DNA LINKING	DT
P2U	DNA LINKING	DU
P2Y	L-PEPTIDE LINKING	PRO
P3M	SACCHARIDE
P3Q	L-PEPTIDE LINKING	TYR
P5P	RNA LINKING	A
P6P	D-SACCHARIDE
PA5	SACCHARIDE
PAQ	L-PEPTIDE LINKING	TYR
PAS	L-PEPTIDE LINKING	ASP
PAT	L-PEPTIDE LINKING	TRP
PAU	L-PEPTIDE LINKING	ALA
PBB	L-PEPTIDE LINKING	CYS
PBF	L-PEPTIDE LINKING	PHE
PBT	DNA LINKING
PCA	L-PEPTIDE LINKING	GLU
PCC	L-PEPTIDE LINKING	PRO
PCE	L-PEPTIDE LINKING
PCS	L-PEPTIDE LINKING	PHE
PDD	D-PEPTIDE LINKING
PDL	L-PEPTIDE LINKING
PDU	DNA LINKING	DU
PEC	L-PEPTIDE LINKING	CYS
PF5	L-PEPTIDE LINKING	PHE
PFF	L-PEPTIDE LINKING	PHE
PFX	L-PEPTIDE NH3 AMINO TERMINUS
PG1	L-PEPTIDE LINKING	SER
PG7	DNA LINKING	DG
PG9	D-PEPTIDE LINKING
PGL	PEPTIDE-LIKE
PGN	DNA LINKING	DG
PGP	RNA LINKING	G
PGY	L-PEPTIDE LINKING	GLY
PHA	L-PEPTIDE LINKING	PHE
PHD	L-PEPTIDE LINKING	ASP
PHE	L-PEPTIDE LINKING
PHI	L-PEPTIDE LINKING	PHE
PHL	L-PEPTIDE LINKING	PHE
PHM	PEPTIDE-LIKE	PHE
PIV	L-PEPTIDE LINKING
PKR	'PEPTIDE-LIKE'	PRO
PLE	PEPTIDE-LIKE
PM3	L-PEPTIDE LINKING	PHE
PMT	RNA LINKING	C
PNA	D-SACCHARIDE
PNG	D-SACCHARIDE
PNW	D-SACCHARIDE
PNZ	L-PEPTIDE COOH CARBOXY TERMINUS
POM	L-PEPTIDE LINKING	PRO
PPH	PEPTIDE-LIKE
PPN	L-PEPTIDE LINKING	PHE
PPU	RNA LINKING	A
PPW	DNA LINKING	DG
PQ1	RNA LINKING
PR0	PEPTIDE-LIKE
PR3	L-PEPTIDE LINKING	CYS
PR5	RNA LINKING	A
PR9	D-PEPTIDE LINKING	PRO
PRK	L-PEPTIDE LINKING	LYS
PRN	DNA LINKING	DA
PRO	L-PEPTIDE LINKING
PRP	SACCHARIDE
PRQ	L-PEPTIDE LINKING
PRR	L-PEPTIDE LINKING
PRS	L-PEPTIDE LINKING	PRO
PRV	L-PEPTIDE LINKING	GLY
PS0	PEPTIDE-LIKE
PSA	L-PEPTIDE LINKING	PHE
PSH	L-PEPTIDE LINKING	HIS
PSI	PEPTIDE-LIKE
PSJ	D-SACCHARIDE
PSS	PEPTIDE-LIKE
PST	DNA LINKING	DT
PSU	RNA LINKING	U
PSV	D-SACCHARIDE
PSW	L-PEPTIDE LINKING	CYS
PTA	PEPTIDE-LIKE
PTH	L-PEPTIDE LINKING	TYR
PTM	L-PEPTIDE LINKING	TYR
PTR	L-PEPTIDE LINKING	TYR
PU	RNA LINKING	A
PUY	RNA LINKING
PVH	L-PEPTIDE LINKING	HIS
PVL	L-PEPTIDE LINKING
PYA	L-PEPTIDE LINKING	ALA
PYO	RNA LINKING	U
PYX	L-PEPTIDE LINKING	CYS
PYY	RNA LINKING
QDS	D-PEPTIDE LINKING	DSN
QLG	L-PEPTIDE LINKING	GLN	LEU	GLY
QPS	SACCHARIDE
QUO	RNA LINKING	G
QV4	D-SACCHARIDE 1,4 AND 1,4 LINKING
R	DNA LINKING	DA
R1A	L-PEPTIDE LINKING	CYS
R1B	L-PEPTIDE LINKING	CYS
R1F	L-PEPTIDE LINKING	CYS
R1P	SACCHARIDE
R1X	D-SACCHARIDE
R2B	D-SACCHARIDE
R2P	D-PEPTIDE LINKING
R7A	L-PEPTIDE LINKING	CYS
RAA	SACCHARIDE
RAE	SACCHARIDE
RAF	D-SACCHARIDE
RAM	SACCHARIDE
RAO	SACCHARIDE
RAT	D-SACCHARIDE
RC7	L-PEPTIDE LINKING	HIS	TYR	GLY
RCY	L-PEPTIDE LINKING	CYS
RDF	PEPTIDE-LIKE
RDP	D-SACCHARIDE
REL	D-SACCHARIDE
RER	SACCHARIDE
RG1	SACCHARIDE
RGG	D-SACCHARIDE
RGI	PEPTIDE-LIKE
RGL	L-PEPTIDE LINKING	ARG
RHA	SACCHARIDE
RIA	RNA LINKING	A
RIB	SACCHARIDE
RIP	SACCHARIDE
RMP	DNA LINKING	DA
RNS	L-SACCHARIDE
RNT	L-SACCHARIDE
ROB	SACCHARIDE
ROC	PEPTIDE-LIKE
RON	L-PEPTIDE LINKING
RPA	SACCHARIDE
RSQ	RNA LINKING	U
RT	RNA LINKING	T
RTP	RNA LINKING
RUB	SACCHARIDE
RX4	PEPTIDE-LIKE
S1H	L-PEPTIDE LINKING	SER
S2C	L-PEPTIDE LINKING	CYS
S2D	D-PEPTIDE LINKING
S2M	DNA LINKING	DT
S2P	L-PEPTIDE LINKING	ALA
S4A	DNA LINKING	DA
S4C	RNA LINKING	C
S4G	DNA LINKING	DG
S4U	RNA LINKING	U
S6G	DNA LINKING	DG
S6P	D-SACCHARIDE
SAC	L-PEPTIDE LINKING	SER
SAH	L-PEPTIDE LINKING	CYS
SAR	PEPTIDE LINKING	GLY
SBD	D-PEPTIDE LINKING	.
SBL	L-PEPTIDE LINKING	SER
SC	DNA LINKING	DC
SC2	PEPTIDE-LIKE
SCH	L-PEPTIDE LINKING	CYS
SCR	SACCHARIDE
SCS	L-PEPTIDE LINKING	CYS
SCY	L-PEPTIDE LINKING	CYS
SD2	L-PEPTIDE LINKING
SDG	DNA LINKING	DG
SDP	L-PEPTIDE LINKING	SER
SEB	L-PEPTIDE LINKING	SER
SEC	L-PEPTIDE LINKING	ALA
SEE	L-PEPTIDE LINKING	SER
SEG	L-PEPTIDE LINKING	ALA
SEL	L-PEPTIDE LINKING	SER
SEM	L-PEPTIDE LINKING
SEN	L-PEPTIDE LINKING	SER
SEP	L-PEPTIDE LINKING	SER
SER	L-PEPTIDE LINKING
SET	L-PEPTIDE LINKING	SER
SGA	SACCHARIDE
SGB	L-PEPTIDE LINKING	SER
SGC	D-SACCHARIDE
SGN	SACCHARIDE
SGS	D-SACCHARIDE
SHB	SACCHARIDE
SHC	L-PEPTIDE LINKING	CYS
SHP	L-PEPTIDE LINKING	GLY
SHR	L-PEPTIDE LINKING	LYS
SIB	L-PEPTIDE LINKING	CYS
SIC	L-PEPTIDE LINKING	ASP	CYS
SIO	SACCHARIDE
SLA	D-PEPTIDE LINKING
SLR	D-PEPTIDE LINKING
SLZ	L-PEPTIDE LINKING	LYS
SMC	L-PEPTIDE LINKING	CYS
SME	L-PEPTIDE LINKING	MET
SMF	L-PEPTIDE LINKING	PHE
SMP	DNA LINKING	DA
SMT	RNA LINKING	T
SNC	L-PEPTIDE LINKING	CYS
SNN	L-PEPTIDE LINKING	ASN
SOC	L-PEPTIDE LINKING	CYS
SOS	DNA LINKING
SOY	L-PEPTIDE LINKING	SER
SPT	DNA LINKING	DT
SRA	RNA LINKING	A
SSG	D-SACCHARIDE
SSU	RNA LINKING	U
STA	PEPTIDE-LIKE
STY	L-PEPTIDE LINKING	TYR
SUB	L-PEPTIDE LINKING
SUC	SACCHARIDE
SUI	L-PEPTIDE LINKING	ASP	GLY
SUN	L-PEPTIDE LINKING	SER
SUP	D-SACCHARIDE
SUR	RNA LINKING	U
SUS	D-SACCHARIDE 1,4 AND 1,4 LINKING
SVA	L-PEPTIDE LINKING	SER
SVZ	L-PEPTIDE LINKING
SXE	L-PEPTIDE LINKING	SER
SYS	L-PEPTIDE LINKING	CYS
T	DNA LINKING
T11	L-PEPTIDE LINKING	PHE
T23	RNA LINKING	T
T2S	RNA LINKING	T
T2T	DNA LINKING
T31	RNA LINKING	U
T32	DNA LINKING	DT
T36	DNA LINKING	DT
T37	DNA LINKING	DT
T38	RNA LINKING	T
T39	RNA LINKING	T
T3P	DNA LINKING	DT
T41	RNA LINKING	T
T48	DNA LINKING	DT
T49	DNA LINKING	DT
T4S	DNA LINKING	DT
T5O	DNA LINKING	DU
T5S	DNA LINKING	DT
T66	L-PEPTIDE LINKING
T6A	RNA LINKING	A
T6P	SACCHARIDE
TA3	DNA LINKING	DT
TA4	L-PEPTIDE LINKING
TAF	DNA LINKING	DT
TAG	D-SACCHARIDE
TAL	RNA LINKING
TAV	L-PEPTIDE LINKING	ASP
TBG	L-PEPTIDE LINKING	GLY
TBM	L-PEPTIDE LINKING	THR
TC1	DNA LINKING	DC
TCB	SACCHARIDE
TCK	PEPTIDE-LIKE
TCP	DNA LINKING	DT
TCQ	L-PEPTIDE LINKING
TCR	L-PEPTIDE LINKING	TRP
TCY	DNA LINKING	DA
TDD	D-PEPTIDE LINKING
TDG	SACCHARIDE
TDY	DNA LINKING	DT
TEF	L-PEPTIDE LINKING	PHE
TFE	DNA LINKING	DT
TFO	DNA LINKING	DA
TFQ	L-PEPTIDE LINKING	PHE
TFT	DNA LINKING	DT
TGP	DNA LINKING	DG
TH1	D-SACCHARIDE
TH6	L-PEPTIDE LINKING	THR
THC	L-PEPTIDE LINKING	THR
THO	L-PEPTIDE LINKING
THR	L-PEPTIDE LINKING
THX	DNA LINKING
THZ	'L-PEPTIDE LINKING'	ARG
TIA	SACCHARIDE
TIH	L-PEPTIDE LINKING	ALA
TIS	L-PEPTIDE LINKING	SER
TLB	RNA LINKING
TLC	DNA LINKING	DT
TLN	DNA LINKING	DU
TM5	SACCHARIDE
TM6	SACCHARIDE
TMB	L-PEPTIDE LINKING	THR
TMD	L-PEPTIDE LINKING	THR
TMR	D-SACCHARIDE
TNB	L-PEPTIDE LINKING	CYS
TNR	L-PEPTIDE LINKING	SER
TNY	L-PEPTIDE LINKING	THR
TOA	SACCHARIDE
TOC	SACCHARIDE
TOX	L-PEPTIDE LINKING	TRP
TP1	DNA LINKING	DT
TPC	DNA LINKING	DC
TPG	RNA LINKING	G
TPH	L-PEPTIDE LINKING
TPL	L-PEPTIDE LINKING	TRP
TPN	PEPTIDE-LIKE
TPO	L-PEPTIDE LINKING	THR
TPQ	L-PEPTIDE LINKING	TYR
TQQ	L-PEPTIDE LINKING	TRP
TRE	SACCHARIDE
TRF	L-PEPTIDE LINKING	TRP
TRG	L-PEPTIDE LINKING	LYS
TRN	L-PEPTIDE LINKING	TRP
TRO	L-PEPTIDE LINKING	TRP
TRP	L-PEPTIDE LINKING
TRQ	L-PEPTIDE LINKING	TRP
TRW	L-PEPTIDE LINKING	TRP
TRX	L-PEPTIDE LINKING	TRP
TS	DNA LINKING
TS9	L-PEPTIDE LINKING	ILE
TST	L-PEPTIDE LINKING
TT	DNA LINKING
TTD	DNA LINKING	DT
TTI	DNA LINKING	DU
TTM	DNA LINKING	DT
TTQ	L-PEPTIDE LINKING	TRP
TTS	L-PEPTIDE LINKING	TYR
TY2	L-PEPTIDE LINKING	TYR
TY3	L-PEPTIDE LINKING	TYR
TY8	L-PEPTIDE LINKING	TYR
TY9	L-PEPTIDE LINKING	TYR
TYB	L-PEPTIDE LINKING	TYR
TYI	L-PEPTIDE LINKING	TYR
TYN	L-PEPTIDE LINKING	TYR
TYO	L-PEPTIDE LINKING	TYR
TYQ	L-PEPTIDE LINKING	TYR
TYR	L-PEPTIDE LINKING
TYS	L-PEPTIDE LINKING	TYR
TYT	L-PEPTIDE LINKING	TYR
TYU	RNA LINKING
TYV	SACCHARIDE
TYX	L-PEPTIDE LINKING
TYY	L-PEPTIDE LINKING	TYR
TZB	L-PEPTIDE LINKING
TZO	L-PEPTIDE LINKING
U	RNA LINKING
U25	RNA LINKING	U
U2L	RNA LINKING	U
U2N	DNA LINKING	DU
U2P	RNA LINKING	U
U31	RNA LINKING	U
U33	DNA LINKING	DU
U34	RNA LINKING	U
U36	RNA LINKING	U
U37	RNA LINKING	U
U8U	RNA LINKING	U
UAL	PEPTIDE LINKING
UAR	RNA LINKING	U
UB2	PEPTIDE-LIKE
UBR	DNA LINKING	DU
UCD	SACCHARIDE
UCL	DNA LINKING	DU
UD5	RNA LINKING	U
UDP	RNA LINKING
UDS	D-PEPTIDE LINKING	DSN
UFP	DNA LINKING
UFR	DNA LINKING	DU
UFT	DNA LINKING	DU
UM1	D-PEPTIDE LINKING	ALA
UM2	L-PEPTIDE LINKING	ALA
UMA	L-PEPTIDE LINKING	ALA
UMP	RNA LINKING	U
UMS	DNA LINKING	DU
UN1	L-PEPTIDE LINKING
UN2	L-PEPTIDE LINKING
UNK	L-PEPTIDE LINKING
UPS	DNA LINKING	DU
UR3	RNA LINKING	U
URD	RNA LINKING	U
URT	DNA OH 3 PRIME TERMINUS
US1	DNA LINKING	DU
US2	DNA LINKING	DU
US3	DNA LINKING	DT
US4	DNA LINKING
US5	RNA LINKING	U
USM	DNA LINKING	DU
V1A	L-PEPTIDE LINKING	CYS
VAD	L-PEPTIDE LINKING	VAL
VAF	L-PEPTIDE LINKING	VAL
VAL	L-PEPTIDE LINKING
VB1	L-PEPTIDE LINKING	LYS
VDL	D-PEPTIDE LINKING
VG1	D-SACCHARIDE
VLL	L-PEPTIDE LINKING
VLM	L-PEPTIDE LINKING
VME	PEPTIDE-LIKE
VMS	L-PEPTIDE LINKING
VOL	L-PEPTIDE LINKING
WFP	L-PEPTIDE LINKING	PHE
X	DNA LINKING	DG
X2F	SACCHARIDE
X2W	L-PEPTIDE LINKING	GLU
X4A	DNA LINKING
X4S	SACCHARIDE
X5S	SACCHARIDE
X97	PEPTIDE-LIKE
X98	PEPTIDE-LIKE
X99	PEPTIDE-LIKE
X9A	PEPTIDE-LIKE
X9Q	L-PEPTIDE LINKING	ALA	PHE	GLY
XAD	DNA LINKING	DA
XAE	DNA LINKING
XAL	DNA LINKING	DA
XAR	DNA LINKING
XBP	SACCHARIDE
XCL	DNA LINKING	DC
XCP	L-PEPTIDE LINKING
XCS	DNA LINKING
XCT	DNA LINKING	DC
XCY	DNA LINKING	DC
XDN	D-SACCHARIDE
XDP	D-SACCHARIDE
XGA	DNA LINKING
XGL	DNA LINKING	DG
XGU	DNA LINKING	DG
XIF	D-SACCHARIDE
XIM	D-SACCHARIDE
XLF	D-SACCHARIDE
XLI	PEPTIDE-LIKE
XLS	D-SACCHARIDE
XMM	D-SACCHARIDE
XPC	PEPTIDE-LIKE
XTH	DNA LINKING	DT
XTL	DNA LINKING	DT
XTR	DNA LINKING	DT
XTS	RNA LINKING	G
XTY	DNA LINKING
XUA	DNA LINKING	DA
XUG	DNA LINKING	DG
XUL	D-SACCHARIDE
XX1	L-PEPTIDE LINKING	LYS
XXY	L-PEPTIDE LINKING	THR	HIS	GLY
XYG	L-PEPTIDE LINKING	ASP	TYR	GLY
XYP	D-SACCHARIDE
XYS	SACCHARIDE
Y	DNA LINKING	DA
Y28	D-PEPTIDE LINKING
YCM	L-PEPTIDE LINKING	CYS
YCP	L-PEPTIDE LINKING
YEN	PEPTIDE-LIKE
YG	RNA LINKING	G
YNM	L-PEPTIDE LINKING
YOF	L-PEPTIDE LINKING	TYR
YRR	DNA LINKING
YYG	RNA LINKING	G
Z	DNA LINKING	DC
Z70	L-PEPTIDE LINKING	HIS
ZAD	RNA LINKING	A
ZAE	D-PEPTIDE LINKING
ZAL	D-PEPTIDE LINKING
ZBC	RNA LINKING	C
ZCY	RNA LINKING	C
ZDU	DNA LINKING	DU
ZFB	L-PEPTIDE LINKING
ZGU	RNA LINKING	G
ZHP	RNA LINKING
ZTH	RNA LINKING	T
ZUK	D-PEPTIDE LINKING
ZZD	L-PEPTIDE LINKING	CYS
ZZJ	L-PEPTIDE LINKING	ALA
ZZU	L-PEPTIDE LINKING
